#############
#     #     #
#     #     #
#           #
#     #     #
########### #
#           ####
#              #
#              #
################