###################
#                 #
############### ###
#                 #
#     ########    #
#     #      #    #
#     #      #    #
#     #      #    #
#                 #
###################
