####################
#                  #
#                  #
#                  #
########### ########
#                  #
#      #           #
#      #           #
####################